Pink Primrose - Wiesiołek Okazały
Hard-leaved Pocket Orchid - Storczyk Twardolistny
Canterbury Bells - Dzwonki Kantarberyjskie
Sweet Pea - Groszek Pachnący
English Marigold - Nagietek Angielski
Tiger Lily - Lilia Tygrysia
Moon Orchid - Księżycowy Storczyk
Bird Of Paradise - Strelicja Królewska (Rajski Ptak)
Monkshood - Tojad
Globe Thistle - Echinops (Kuliste Ciernie)
Snapdragon - Lwia Paszcza
Colt's Foot - Podbiał Pospolity
King Protea - Protea Królewska
Spear Thistle - Oset
Yellow Iris - Żółta Irysa
Globe-flower - Kulnik
Purple Coneflower - Jeżówka Purpurowa
Peruvian Lily - Alstremeria Peruwiańska
Balloon Flower - Dzwonek Wielkokwiatowy
Arum Lily - Lilia Wodna (Calla)
Fire Lily - Ognista Lilia
Pincushion Flower - Szarłat
Fritillary - Szachownica
Red Ginger - Czerwony Imbir
Grape Hyacinth - Szafirek
Corn Poppy - Mak Polny
Prince Of Wales Feathers - Pióra Księcia Walii
Stemless Gentian - Goryczka Bezłodygowa
Artichoke - Karczoch
Sweet William - Goździk Brodaty
Carnation - Goździk
Garden Phlox - Floks Wiechowaty
Love In The Mist - Czarnuszka Damascena
Mexican Aster - Aster Meksykański
Alpine Sea Holly - Ostrożeń Alpejski
Ruby-lipped Cattleya - Storczyk Cattleya
Cornish Lily - Lilia Kornwalijska
Great Masterwort - Wielki Kopytnik
Siam Tulip - Tulipan Syjamski
Lenten Rose - Ciemiernik
Barbeton Daisy - Gerbera
Daffodil - Żonkil
Sword Lily - Mieczyk
Poinsettia - Gwiazda Betlejemska
Bolero Deep Blue - Bolero Głęboki Niebieski
Wallflower - Lak Pachnący
Marigold - Nagietek
Buttercup - Jaskier
Oxeye Daisy - Złocień Właściwy
Common Dandelion - Mniszek Lekarski
Petunia - Petunia
Wild Pansy - Fiołek Polny
Primula - Pierwiosnek
Sunflower - Słonecznik
Pelargonium - Pelargonia
Bishop Of Llandaff - Dalia 'Bishop of Llandaff'
Gaura - Gaura
Geranium - Pelargonia
Orange Dahlia - Pomarańczowa Dalia
Pink-yellow Dahlia - Różowo-Żółta Dalia
Cautleya Spicata - Cautleya Szpicata
Japanese Anemone - Zawilec Japoński
Black-eyed Susan - Rudbekia Dwubarwna
Silverbush - Krzew Srebrzysty
Californian Poppy - Mak Kalifornijski
Osteospermum - Osteospermum
Spring Crocus - Krokus Wiosenny
Bearded Iris - Irys Brodaty
Windflower - Zawilec
Tree Poppy - Mak Drzewiasty
Gazania - Gazania
Azalea - Azalia
Water Lily - Grzybień (Lilia Wodna)
Rose - Róża
Thorn Apple - Bieluń Dziędzierzawa
Morning Glory - Powojnik
Passion Flower - Męczennica
Lotus - Lotos
Toad Lily - Lilia Ropucha
Anthurium - Anturium
Frangipani - Plumeria
Clematis - Powojnik
Hibiscus - Hibiskus
Columbine - Orlik
Desert-rose - Róża Pustynna
Tree Mallow - Ślazowiec
Magnolia - Magnolia
Cyclamen - Cykamen
Watercress - Rukiew Wodna
Canna Lily - Kanna
Hippeastrum - Hippeastrum
Bee Balm - Pysznogłówka
Ball Moss - Mech Kulisty
Foxglove - Naparstnica
Bougainvillea - Bugenvillea
Camellia - Kamelia
Mallow - Ślaz
Mexican Petunia - Petunia Meksykańska
Bromelia - Bromelia
Blanket Flower - Gaillardia
Trumpet Creeper - Milin Amerykański
Blackberry Lily - Irys Dziki